11111111111111111111
10000000000000000001
10200000000000000001
11111100000000000001
10000000000003000001
10000001111111111111
10000000000000000001
10003000000000000301
11111110000111111111
10000000000000000001
10000000000300000001
10000001111111111111
10000000000000000001
10003000000300000001
11111111111110000001
10000000000000000001
10000000000003000001
11111111111111111111