11111111111111111111
10000000000000000001
10000000000000000001
10000000000000000001
10000000111000000001
10000000000000000001
10000000000000000001
10000011100111000001
10000000000030000001
10000000000000000001
10000011111111000001
10000000000000000001
10000000000000000001
10000010001000000001
10011110001111111001
10000000000000010001
10000000000030012001
11111111111111111111