11111111111111111111
10000000000000000001
10000000000000000001
10011111000011111001
10000001000010000001
10000001000010000001
10000010020010000001
10000100011000100001
10001000100100010001
10000001000010000001
10000010000001000001
10010000000000001001
10011111100111111001
10000000000000000001
10000011111111000001
10000000000000000001
10000000000000000001
11111111111111111111