11111111111111111111
10000000000000000001
10000000000000000001
10000000020000000001
10000001111110000001
10000000000000000001
10000000000000000001
10000111111111100001
10000000000000000001
10003000000000030001
10001000000000010001
11111000000000011111
10000000000000000001
10000030000000030001
10011111000011111001
10000000000000000001
10000000000000000001
11111111111111111111