11111111111111111111
10000000000000000001
10000000000000000001
10000000000000020001
11111100000000111111
10000000000000000001
10000000000000000001
10000000000000000001
11110001111110001111
10000000000000000001
13003003003003003001
11001001001001001001
10000000000000000001
10000000000000000001
11110000010000001111
10000000000000000001
10000000000000000001
11111111111111111111