11111111111111111111
10000000000000000001
10000000000000000001
10000000000000000001
11110001111110001111
10000000000000000001
10000000000000000001
10000100000000100001
11111100000000111111
10000000000000000001
10000000000000000001
10000011111111000001
10000000000000000001
10000000020000000001
11111111111111111111
10000000000000000001
13030303030303030301
11111111111111111111