11111111111111111111
10000000000000000001
10200000000000000001
10110000000000003001
10000000000000000001
10000110000000000001
10000000000000000001
10000000110000030001
10000000000000000001
10000000000110000001
10000000000000000001
10000001100000000001
10000000000000000001
10000000000000000001
11111110000000000001
10000010000000000001
10000013333333333331
11111111111111111111