11111111111111111111
10000000000000000001
10000000000000000001
10011100000000111001
10000000000000000001
10000000000000000001
10000101111110100001
10000000000000000001
10000011100111000001
10000000000000000001
10000000000000000001
10000011111111000001
10000000000000000001
10000000000000000001
10011100000000111001
10000000000000000001
10000000000000002001
11111111111111111111