11111111111111111111
10000000000000000001
10000000000000000001
10000000000000000001
10000000000000000001
10000001111110000001
10000000000000000001
10030000000000003001
11111000000000011111
10000000000000000001
10000000030000000001
10000111111111000001
10000000000000000001
10000000000000000001
10011111001111111001
10000000000000000001
10000000000000002001
11111111111111111111