11111111111111111111
10000000000000000001
10000000000000000001
11111111110000000001
10000000000000000001
10000000000000000001
12000000000000000001
11110000000000000001
10000000000000000001
10000110000000000001
10000000000000000001
10000000000000000001
10000000110000000001
10000000000000000001
10000000000000000001
11111111111111111111
13333333333333333331
11111111111111111111