11111111111111111111
10000000000000000001
10000000000000000001
10011100000000111001
10000000000000000001
10000003000000000001
10000101111110100001
10000000000030000001
10000011100111000001
10000000000000000001
10000000000000000001
10000011111111000001
10010000000000000001
11010000000000000001
10011100000000111001
10000000000000000001
10000000000030002001
11111111111111111111