11111111111111111111
10000000000000000001
10000000000000000001
10013000000000000001
10010000000000000001
10011111100000000001
10000000100000000001
10000030100100001001
10011111100110101001
10000000000101301001
10000000000100101001
10001000000101011001
10001000000100001001
10001002000000000001
10001111110000000001
10000000000000000001
10000000000000000001
11111111111111111111