11111111111111111111
10000000000000000001
10000000000000000001
10110000000000000001
10000000000000000001
10000011000000000001
10000000000000000001
10000000111000000301
10000000001111111111
10000000000000000001
10000000000300000001
10000001111111111111
10000000000000000001
10030000030000000001
11111111111110000001
10000000000000000001
10200000000000300001
11111111111111111111