11111111111111111111
10000000000000000001
10000000000000000001
10000000000000000301
10000001111111111111
10000000000000000001
10000000000000000001
10000000300000000001
11111111111110000001
10000000000000000001
10000000000000300001
10000001111111111111
10000000000000000001
10000300000000000001
11111111111110000001
10000000000000000001
10200000003000000301
11111111111111111111